WWWWWWWWWWWWWWWWWWWW
WGGGGGGGGWWGGGGGGGGW
WGGGGGGGGWWGGGGGGGGW
WGGGVGGWWWWGGGGGGWWW
W3GGGGGG#WW4GGVGGG$W
WGGGGGGWWWWGGGGGGWWW
WGGGGGGGGWWGGGGGGGGW
WGGGGGGGGWWGGGGGGGGW
WGGGGGGGGWWGGGGGGGGW
WWWWWWWWWWWWWWWWWWWW
WWWWWWWWWWWWWWWWWWWW
WGGGGGGGGWWGGGGGGGGW
WGGGGGGGGWWGGGGGGGGW
WGGGVGGWWWWGGGGGGWWW
W2GGGGGG@WW1GGVGGG!W
WGGGGGGWWWWGGGGGGWWW
WGGGGGGGGWWGGGGGGGGW
WGGGGGGGGWWGGGGGGGGW
WGGGGGGGGWWGGGGGGGGW
WWWWWWWWWWWWWWWWWWWW
